11111111111111111111111111111111111111111111
10000000001110000001000000100000001111111111
1P000000001110000000100001000000000011111111
11110000001110000000011110000000000011111111
10000011001110000000000000000000000000000011
10110000001110000100000000000100000000111111
10000011001110001110000000001110000000000111
10110000001110000100000000000100000001000001
10000011000000000000000000000000000000000001
10000000000000000000000000000000000101000CE1
11111111111111111111111111111111111111111111
