11111111111111111111
10000000100000000001
10000P00C000C0000001
100000000000100E0001
11111111111111111111
