1111111111111111111111111111111111111111111
1000000000000011111111111000000000000000001
1000000000000100000000000100000000000000001
1000000000001000000000000010000000000000001
1000000000010001111111111110000000000000001
1000000000011010000000000010000000000000001
100000000001C000000001000010000000000000001
10000C000001111100111111111000000000C001001
1000000000010000100000000010000000000001001
1P000000000000000000000000000000000000010E1
1111111111111111111111111111111111111111111
